1 1 1 1 1 1 1 1 1 1 1 1 1 1 1 1
2 2 2 2 2 2 2 2 2 2 2 2 2 2 2 2
1 1 1 1 1 1 1 1 1 1 1 1 1 1 1 4
5 5 5 5 5 5 5 5 5 7 7 7 7 5 5 5
0 0 0 0 0 0 0 0 0 9 3 3 10 0 0 1
0 0 0 0 0 0 0 0 0 9 2 2 10 0 0 1
0 0 0 0 0 0 0 0 0 9 2 2 10 0 0 1
0 0 0 0 0 0 0 0 0 6 6 6 6 0 0 1
0 0 0 0 0 0 0 0 0 0 0 0 0 0 0 1
1 1 1 1 1 1 1 1 1 4 4 4 4 4 4 1
